1111111111111111111111111111111111111111
10001P0000000000000000000000000000000001
100C100000000000000000000000000000000001
1011111000000000000000000000000000000001
1000E00000000000000000000000000000000001
1111111111111111111111111111111111111111
