1111111111111111111111111111111111
11111010C0C0C0C0C0C0C0C00C0C00E001
1100CC0C0C00C0C0C00C0C0C00C0C00C01
1000CC0C0C00C00C0C00C0000C00C00C11
1000C1111111C0C0C000C0C0000C0C0C01
1000CC0C0C00C0C01110C0C00C0C000001
1000CC0CPC00C0C0C000C0CC00C0CC0001
1000CC0C0C00C0C0C00C0C00C00C00C001
1000CC0C0000CCC0C00C0C00C0000CC001
1111111111111111111111111111111111