111111111111111111111111111111111111
10000E00C0C0C0C0C0C0C0C00C0C00C0P101
10000000000CCCC00000C0C0C0C0C0C00001
10000000000CCCC00000C0C0C0C0C0C00001
10000000000CCCC00000111010C0C0C0C001
10000000000CCCC00000C0C0C0C0C0C00001
10000000000CCCC00000C0C0C0C0C0C00001
10000000000CCCC00000C0C0C0C0C0C00001
10000000000CCCC00000C0C0C0C0C0C00001
10000000000CCCC00000C0C0C0C0C0C00001
10000000000CCCC00000C0C0C0C0C0C00001
111111111111111111111111111111111111